#################
#S....#.........#
#.###.#.#####.#.#
#.#.#.#...#...#.#
#.#.#.#####.###.#
#.#.....#...#.#.#
#.#####.#.###.#.#
#.....#...#....E#
#################